border_size=1
usage=map

_off^_usr   , _off^_usr   , _off^_usr   , _off^_usr   , _off^_usr   , _off^_usr   , _off^_usr   , _off^_usr   , _off^_usr   , _off^_usr   , _off^_usr   , _off^_usr   , _off^_usr   , _off^_usr   , _off^_usr   , _off^_usr   , _off^_usr   , _off^_usr   , _off^_usr   , _off^_usr   , _off^_usr   , _off^_usr   
_off^_usr   , Xu          , Xu          , Xu          , Xu          , Xu          , Xu          , Xu          , Xu          , Xu          , Xu          , Xu          , Xu          , Xu          , Xu          , Xu          , Xu          , Xu          , Xu          , Xu          , Xu          , _off^_usr   
_off^_usr   , Xu          , Xu          , Xu          , Xu          , Xu          , Xu          , Xu          , Xu          , Xu          , Qxu         , Xu          , Xu          , Xu          , Xu          , Xu          , Xu          , Xu          , Xu          , Xu          , Xu          , _off^_usr   
_off^_usr   , Xu          , Xu          , Xu          , Xu          , Xu          , Xu          , Xu          , Qxu         , Qxu         , Mm          , Qxu         , Qxu         , Xu          , Xu          , Xu          , Xu          , Xu          , Xu          , Xu          , Xu          , _off^_usr   
_off^_usr   , Xu          , Xu          , Xu          , Xu          , Xu          , Dd^Do       , Uu          , Ds          , Dd          , 1 Kh        , Dd          , Ds          , Uu          , Dd^Do       , Xu          , Xu          , Xu          , Xu          , Xu          , Xu          , _off^_usr   
_off^_usr   , Xu          , Xu          , Xu          , Qxu         , Uu          , Xu          , Xu          , Hd          , Ch          , Ch          , Ch          , Hd          , Xu          , Xu          , Uu          , Qxu         , Xu          , Xu          , Xu          , Xu          , _off^_usr   
_off^_usr   , Xu          , Qxu         , Qxu         , Dd          , Ds          , Hd          , Xu          , Mm          , Ch          , Ggf         , Ch          , Mm^Xm       , Xu          , Hd          , Ds          , Dd          , Qxu         , Qxu         , Xu          , Xu          , _off^_usr   
_off^_usr   , Xu          , Qxu         , Mm          , 5 Kh        , Ch          , Ch          , Mm^Xm       , Mm^Xm       , Ha          , Ai          , Aa^Fpa      , Mm^Xm       , Mm          , Ch          , Ch          , 4 Kh        , Mm          , Qxu         , Xu          , Xu          , _off^_usr   
_off^_usr   , Xu          , Qxu         , Dd          , Ch          , Ch          , Ggf         , Aa^Fpa      , Ha          , Aa^Fpa      , Ss          , Ha          , Aa^Fpa      , Ha          , Ggf         , Ch          , Ch          , Dd          , Qxu         , Xu          , Xu          , _off^_usr   
_off^_usr   , Xu          , Uu          , Ds          , Hd          , Ch          , Ha          , Ai          , Ss          , Rr          , Wwf         , Rr          , Ss          , Ai          , Aa^Fpa      , Ch          , Hd          , Ds          , Uu          , Xu          , Xu          , _off^_usr   
_off^_usr   , Xu          , Dd^Do       , Xu          , Xu          , Mm          , Mm^Xm       , Aa^Fpa      , Rr          , Wwf         , Dd^Do       , Wwf         , Rr          , Ha          , Mm^Xm       , Mm^Xm       , Xu          , Xu          , Dd^Do       , Xu          , Xu          , _off^_usr   
_off^_usr   , Xu          , Uu          , Xu          , Hd          , Mm^Xm       , Aa^Fpa      , Ha          , Ss          , Wwf         , Wwf         , Wwf         , Ss          , Aa^Fpa      , Ha          , Mm          , Hd          , Xu          , Uu          , Xu          , Xu          , _off^_usr   
_off^_usr   , Xu          , Qxu         , Ds          , Ch          , Ch          , Ggf         , Ai          , Aa^Fpa      , Rr          , Ss          , Rr          , Ha          , Ai          , Ggf         , Ch          , Ch          , Ds          , Qxu         , Xu          , Xu          , _off^_usr   
_off^_usr   , Xu          , Qxu         , Dd          , 3 Kh        , Ch          , Ch          , Ha          , Mm^Xm       , Ha          , Ai          , Aa^Fpa      , Mm^Xm       , Aa^Fpa      , Ch          , Ch          , 2 Kh        , Dd          , Qxu         , Xu          , Xu          , _off^_usr   
_off^_usr   , Xu          , Qxu         , Mm          , Dd          , Ch          , Hd          , Mm          , Mm^Xm       , Aa^Fpa      , Ggf         , Ha          , Mm          , Mm^Xm       , Hd          , Ch          , Dd          , Mm          , Qxu         , Xu          , Xu          , _off^_usr   
_off^_usr   , Xu          , Xu          , Qxu         , Qxu         , Ds          , Xu          , Xu          , Hd          , Ch          , Ch          , Ch          , Hd          , Xu          , Xu          , Ds          , Qxu         , Qxu         , Xu          , Xu          , Xu          , _off^_usr   
_off^_usr   , Xu          , Xu          , Xu          , Xu          , Uu          , Dd^Do       , Xu          , Ds          , Ch          , 6 Kh        , Ch          , Ds          , Xu          , Dd^Do       , Uu          , Xu          , Xu          , Xu          , Xu          , Xu          , _off^_usr   
_off^_usr   , Xu          , Xu          , Xu          , Xu          , Xu          , Xu          , Uu          , Qxu         , Dd          , Mm          , Dd          , Qxu         , Uu          , Xu          , Xu          , Xu          , Xu          , Xu          , Xu          , Xu          , _off^_usr   
_off^_usr   , Xu          , Xu          , Xu          , Xu          , Xu          , Xu          , Xu          , Xu          , Qxu         , Qxu         , Qxu         , Xu          , Xu          , Xu          , Xu          , Xu          , Xu          , Xu          , Xu          , Xu          , _off^_usr   
_off^_usr   , Xu          , Xu          , Xu          , Xu          , Xu          , Xu          , Xu          , Xu          , Xu          , Xu          , Xu          , Xu          , Xu          , Xu          , Xu          , Xu          , Xu          , Xu          , Xu          , Xu          , _off^_usr   
_off^_usr   , Xu          , Xu          , Xu          , Xu          , Xu          , Xu          , Xu          , Xu          , Xu          , Xu          , Xu          , Xu          , Xu          , Xu          , Xu          , Xu          , Xu          , Xu          , Xu          , Xu          , _off^_usr   
_off^_usr   , _off^_usr   , _off^_usr   , _off^_usr   , _off^_usr   , _off^_usr   , _off^_usr   , _off^_usr   , _off^_usr   , _off^_usr   , _off^_usr   , _off^_usr   , _off^_usr   , _off^_usr   , _off^_usr   , _off^_usr   , _off^_usr   , _off^_usr   , _off^_usr   , _off^_usr   , _off^_usr   , _off^_usr   
